####################
#..............X...#
#..s...s....s......#
#........*.........#
#....*.......s.....#
#......s...........#
#..P...............#
####################
