####################
#P......s....s..X..#
#..*....s....s.....#
#..*....s....s.....#
#..................#
####################
