########################
#P........s............#
#..#####..see#####.....#
#..#***...s..#***....X.#
#..#####..s..#####.....#
########################
