########################
#P.....................#
#..s.s.s.s.s.s.s.s.ss..#
#..*.*.*.*.*.*.*.*.*X..#
#......................#
########################
