########################################
#......................................#
#.P....................................#
#..ssssssssssssssssssssssssss..........#
#......................................#
#......................................#
#...*****.***.**.**.***********........#
#......................................#
#......................................#
#.....#########........................#
#.#####.......####.....................#
#................###...................#
#..........*.......#####......X........#
#..........*...........##..............#
#...*********...........##.............#
#....***********.........##............#
#.....**************...................#
#.....*****************................#
#......*********.......................#
#......................................#
#......................................#
#......................................#
#......................................#
#......................................#
########################################
