##############################
#P.......#.........#.........#
#........#.........#.........#
#.####...#.........#..####...#
#...*....#...*..s..#.........#
#........#.........#.........#
#...#....#...####..#....#....#
#...#...*..............*.#...#
#...#....#...####..#....#....#
#........#.........#.......X.#
#........#.........#.........#
##############################
