########################
#P..........s..........#
#..........*...........#
#......####............#
#...*..#........*..s...#
#......#.....*.........#
#......####............#
#...........*......s.X.#
#......................#
########################
