########################
#P.s.s.s.s.s.s.s.s.s...#
#......................#
#..*...*...*...........#
#......................#
#..........s.s.s.s.s...#
#......................#
#.............*...*..*.#
#....................X.#
########################
