##############################
#P.....s......#............s.#
#.............#..............#
#...*..s......#......*.......#
#.............#..............#
#.............e..............#
#.............e..............#
#...*..s......#......*..s....#
#.............#..............#
#....*........#........*..X..#
#..........s..#.......s......#
##############################
