####################
#.....*....#ss.....#
#....P.....#**e....#
#..........*..e....#
#..........#....X..#
####################
#.#.#..#..##..##..##
